0000000000000000000000000000
0411111111111001111111111140
0100001000001001000001000010
0100001000001001000001000010
0100001000001001000001000010
0111111111111111111111111110
0100001001000000001001000010
0100001001000000001001000010
0111111001111001111001111110
0000001000003003000001000000
0000001000003003000001000000
0000001003333333333001000000
0000001003000000003001000000
0000001003033333303001000000
3333331333033333303331333333
0000001003033333303001000000
0000001003000000003001000000
0000001003333333333001000000
0000001003000000003001000000
0000001003000000003001000000
0111111111111001111111111110
0100001000001001000001000010
0100001000001001000001000010
0111001111111111111111001110
0001001001000000001001001000
0001001001000000001001001000
0111111001111001111001111110
0100000000001001000000000010
0100000000001001000000000010
0411111111111111111111111140
0000000000000000000000000000
